------------------------------------------------------------------------------------------------------------------------
------------------------------------------------------------------------------------------------------------------------
------------------------------------------------------------------------------------------------------------------------
------------------------------------------------------------------------------------------------------------------------
------------------------------------------------------------------------------------------------------------------------
------------------------------------------------------------BBBBBBBBBBBBBBBBBBBBBBBBBBBBBB-----------------------------F
------------------------------------------------------------BBBBBBBBBBBBBBBBBBBBBBBBBBBBBB-----------------------------F
------------------------------------------------------------BBBBBBBBBBBBBBBBBBBBBBBBBBBBBB-----------------------------F
----------------------------------BBBBBB-------------------------------------------------------------------------------F
------------------------------B---BBBBBB---------BBBBBB--------------------------------------B---------------------BB--F
----------S------B---S----B---B---BBBBBB---------BBBBBB--SS----S----SS----S----SS--------------B-SS----S-B------BB-----F
BBBBBBBBBBBBBBBBBBBBBBBBBBBBBBBBBBBBBBBB----BB---BBBBBB-BBBBBBBBBBBBBBBBBBBBBBBBBBBBBBBBBBBBBBBBBBBBBBBB----BBBBBBBBBBBBB