-----------------------------------------------------------------------------------------
-----------------------------------------------------------------------------------------
-----------------------------------------------------------------------------------------
-----------------------------------------------------------------------------------------
-----------------------------------------------------------------------------------------
-----------------------------------------------------------------------------------------
----------------------------------------------------------------------------------------F
---------------------------------------------------S------------------------------------F
--------------------------------------S------------B--------S---------------------------F
------------------S-------------------B--------B---B--------B----S----------------------F
----------S-------B--------S----------B----S---B---B--------B----B---------S------------F
BBBBBBBBBBBBBBBBBBBBBBBBBBBBBBBBBBBBBBBBBBBBBBBBBBBBBBBBBBBBBBBBBBBBBBBBBBBBBBBBBBBBBBBBB