------------------------------------------------------------------------------------------------------------------------
------------------------------------------------------------------------------------------------------------------------
------------------------------------------------------------------------------------------------------------------------
------------------------------------------------------------------------------------------------------------------------
------------------------------------------------------------------------------------------------------------------------
------------------------------------------------------------------------------------------------------------------------
------------------------------------------------------------------------------------------------------------------------
------------------------------------------------------------------------------------------------------------------------
------------------------------------------------------------------------------------------------------------------------
---------------------------------------------S-------------------------------------------------------------------------F
-----------------BB--------SS--------S-------B----------B----S----------B-------B----------SS----------S-------B-----F
BBBBBBBBBBBBBBBBBBBBBBBBBBBBBBBBBBBBBBBBBBBBBBBBBBBB--BBBBBBBBBB--BBBBBBBBBBBBBBBBBB--BBBBBBBBBBBB--BBBBBBBBBBBBBBBBBBBB