--------------------------------------------------------------------------------
--------------------------------------------------------------------------------
--------------------------------------------------------------------------------
--------------------------------------------------------------------------------
--------------------------------------------------------------------------------
--------------------------------------------------------------------------------
--------------------------------------------------------------------------------
---------------------------------------------------S----------------------------
--------------------------------------S------------B--------S-------------------
------------------S-------------------B--------B---B--------B----S--------------
----------S-------B--------S----------B----S---B---B--------B----B---------S----
BBBBBBBBBBBBBBBBBBBBBBBBBBBBBBBBBBBBBBBBBBBBBBBBBBBBBBBBBBBBBBBBBBBBBBBBBBBBBBBB